NO ./textures/greystone.xpm
SO ./textures/mossy.xpm
WE ./textures/eagle.xpm
EA ./textures/wood.xpm

F 220,100,0
C 225,30,0

        1111111111111111111111111
        1000000000000000000000001
        1000000000000000000000001
111111111000000000000000000011111
10000000000000000000000000001
10000000000000000000000000001
10000000000000000000000000001
10000000000000010000000000001
10000000000000000000000000001
100000000000000N0000000000001
10000000000000000000000000001
10000000000000000000000000001
10000000000000000000000000001
11111111111111111111111111111